GGGGGGGGwGbbbGGGGbGGwGGGbGGGGGGGwGGw
GGGGGGGGGwwGGbGGwGGGGwGGGbGGwGGbGwGG
bbGGbGGbbGGGGGGGwGGbGbGGGGGGwGGGGGGG
GGwGGGGbGwwGbGGGGGGGbGGGGwGGwGGbGbGb
GGwwGbGGGGGGwGGGbGGGwGGwGGGGbGwGwGGG
GGGbGwGGwGGGbGGGGGGGGGGwGGwGGGGGGbbG
GbGGGwGGGGbbGwGGGGGGwbGbGbGGwwGGGGGG