wGGGGwwGGGwGGGGbGwGGGGbGwGbwGGGGbGGG
GGwGGGGGGGGbwbGGwGGwGGGGGGGGbbGGbwGG
GGbGGwGwGGGGGGGGwwGGwGGGbGGGGGGGbbGG
bGGwGGGGbGGGGGbGGGGwGGwGGGGGGbGbbGGG
GGGGGbGGwGbbGbGwGGGGGGGGwGGGGGGGwGwG
bGGGGGGGwGbGGGGGGwGGwGGGGGGGGbbGGbGb